8 8
c 5 c 5 c 5 c 5
f c 4 c 4 c 4 f
f f r c c r c f
f c f c c c c c
c c c c c c c c
c c c c r c c c
o o o o o o o o
o o o o o o o o