8 8
3 c 1 c 1 c 1 c
r c r c r c r c
c c c c c c c c
f c f f f f c f
f c f f f f c f
c c c c c c c c
c r c r c r c r
o o o o o o o o
