8 8
c 1 c c c c c c
c c c c c c c c
c c 1 c c c c c
c c c c c c c c
o o o o o o o o
o o o o o o o o
o o o o 2 o o o
o o o o o o o o
