8 8
1 c c c c 4 c c
c c c c c c 4 4
c 1 c c c c c c
c c c o o c c c
c c c o o c c c
c c c c c c c c
c c c c c c c c
2 c 3 c c c c c
